####################
#                  #
# *...............*#
# .# .########### .#
# .# .########### .#
# .  .            .#
# .................#
# .# .####DD##### .#
# .# .##       ## .#
# .# .## G GGG ## .#
# .# .########### .#
# .  .            .#
# ........ P.......#
# .# .########### .#
# .  .            .#
# *...............*#
####################