####################
#                  #
# *...............*#
# .# .########### .#
# .# .########### .#
# .  .            .#
# .................#
# .# .####DD##### .#
# .# .##   G  ### .#
# .# .## G G G### .#
# .# .########### .#
# .  .            .#
# .................#
# .# .########### .#
# .# .            .#
# .# .......P......#
# .# .##########  .#
# .               .#
# *...............*#
####################