#####################
#                   #
# *................*#
# .## .## .## .### .#
# .## .## .## .### .#
# .   .   .   .    .#
# ..................#
# .# .#####DD##### .#
# .# .# #      # # .#
# .# .# # G G G# # .#
# .# .####DD###### .#
# .  .#     #      .#
# ....# ....# ......#
# .# .# .# .# .### .#
# .# .  .  .  .    .#
# .# ........P......#
# .#  ############ .#
# .                .#
# *................*#
#####################