 ############################# 
 #             #             # 
 # ............# ............# 
 # .### .#### .# .#### .### .# 
 # *### .#### .# .#### .### *# 
 # .    .     .  .     .    .# 
 # ..........................# 
 # .### .# .####### .# .### .# 
 # .    .# .   #    .# .    .# 
 # ......# ....# ....# ......# 
 ###### .#### .# .#### .###### 
      # .#    .  .   # .#      
      # .# ..........# .#      
      # .# .##DDD## .# .#      
      # .  .#     # .  .#      
      # ....# GGGG# .  .#      
      # .# .####### .# .#      
      # .# .        .# .#      
      # .# ..........# .#      
 ###### .# .####### .# .###### 
 #      .  .   #    .  .     # 
 # ............# ............# 
 # .### .#### .# .#### .### .# 
 # .  # .     .  .     .#   .# 
 # *..# ....... P.......# ..*# 
 ### .# .# .####### .# .# .### 
 #   .  .# .   #    .# .  .  # 
 # ......# ....# ....# ......# 
 # .######### .# .######### .# 
 # .          .  .          .# 
 # ..........................# 
 ############################# 