####################
#                  #
# .................#
# .# .########### .#
# .# .########### .#
# .  .          # .#
# ....GGG..G....# .#
# .# .####DD##### .#
# .# .##      ### .#
# .# .##      ### .#
  .  .########### . 
 .....            . 
#### ..............#
#  # .########### .#
# .# .            .#
# .# .....*.P......#
# .#  ########### .#
# .               .#
# .................#
####################