####################
#                  #
#         .........#
#         ####### .#
#               # .#
#               # .#
#          G    # .#
#      ###DD##### .#
#      #      #   .#
#      # G G G#   .#
       ########     
                    
#      .........   #
#       #######    #
#                  #
#         * P      #
#       #######    #
#                  #
#                  #
####################