####################
#..................#
#..................#
#..................#
#..................#
#..................#
#..................#
#..................#
#..........##......#
#..........##......#
...........##.......
....................
#..................#
#..................#
#..................#
#..................#
#..................#
#..................#
#..................#
####################