####################
#                  #
# ...........G.....#
# .# .########### .#
# .# .########### .#
# .  .          # .#
# ......G..G....# .#
# .# .####DD##### .#
# .# .##      ### .#
# .# .##      ### .#
  .  .########### . 
 .....            . 
#### ..............#
#  # .########### .#
# .# .            .#
# .# .....*.P......#
# .#  ########### .#
# .               .#
# ..........G......#
####################